                        
NO    ./path_to_the_north_texture
SO ./path_to_the_south_texture
WE ./path_to_the_west_texture
EA ./path_to_the_east_texture

F 182,170,112
C 178,255,255





1111111111111111111111111
1N000000000110000000000001
1011000001110000000000001
100100000000000000000000111111111
101111111011000001110000000000001
100000000011000001110111111111111
10110111111111011100000010001
10110111111111011101010010001
10000000110101011100000010001
10000000000000001100000010001111111111
10000000000000000000000000000000000001
100000011101010111110111100011111111111
10110111 1110101 101111010001
11111111 1111111 111111111111


