                        
NO ./wall_nord.xpm
SO ./wall_sud.xpm
WE ./wall_ovest.xpm
EA ./wall_est.xpm

F 182,170,112
C 178,255,255

 1111111111111111111111111111
100000000000000000000000000001111
10000000000000000000011100000000011111
10000000000W000000000101000000000000001
10000000000000000000011100000000000001
 111111111111111111111111111111111111