                        
NO ./wall_nord.xpm
SO ./wall_sud.xpm
WE ./wall_ovest.xpm
EA ./wall_est.xpm

F 182,170,112
C 178,255,255





11111111111111111111111111111
10000000000000000000000000001
101000000000000N0000000000001
10000000000000000000000000111
10100000000000000000000000001
10000000000000000011111100111
10100000000000000000000000001
10100000000000000000000000001
10000000000000000000000000001
10100000000000000000000000001
10000000000000000000000000001
10000000000000000000000000001
10110111111101011101111010001
11111111 1111111 1111111111111


