                        
NO ./wall_nord.xpm
SO ./wall_sud.xpm
WE ./wall_ovest.xpm
EA ./wall_est.xpm

F 182,170,112
C 178,255,255





11111111111111111111111111111
10000000000000000000000000001
10000000000000000000000000001
10000000000000000000000000001
10000000000000000000000000001
10000000000000000000000000001
10000000000000000000000000001
10000000000000000000000000001
1DDDDDDDDDDDDDDDDDDDDDDDDDDD1
10000000000000000000000000001
10000000000000000000N00000001
10000000000000000000000000001
10110111111101011101111010001
11111111111111111111111111111
